11111111111111111111111111111111111111111111111111111111111111111111
100000000000000C00000C0000100000011000000000C0000000000C000100010001
1010010100100000101001000010010100100000100000000C000011000101010101
1010010010101010001C01000010010100001000100001100100001100010101C101
100000000C00C0000000000111000000C1000000100001100000001C000101010101
1010010100100000101001000000000100100000100000001C001000000101010101
1010010010101010001C0100000101010001000010000C000001100000010101C101
100000000C00C0000000000000010000C1000000100000001110000C0001010101C1
1010010010101010001C01000010010100001000100001000100001100010101C101
100000000C00C0000000000101000000C1000000100001100000001C000101010101
1011010100100000101001000000000100100000100000101C011000000101010101
100111111111111111111111111101010001000010000C000001000000010101C101
1P0000000C00C0000000000000000000C1000000100000001010000C0000010001C1
11111111111111111111111111111111111111111111111111111111111111111101
10000000000000000000000000000000000000000000000000000000000000000001
10111111111111111111111111111111111111111111111111111111111111111111
10000000000000000000000000000000000000000000000000000000000000000001
11111111111111111111111111111111111111111111111111111111111111111101
10000000000000000000000000000000000000000000000000000000000000000001
10111111111111111111111111111111111111111111111111111111111111111111
10000000000000000000000000000000000000000000000000000000000000000001
11111111111111111111111111111111111111111111111111111111111111111101
10000000000000000000000000000000000000000000000000000000000000000001
10111111111111111111111111111111111111111111111111111111111111111111
1000000000000000000000000000000000000000000000000000000000000R0000C1
11111111111111111111111111111111111111111111111111111111111111111111