1111111111111
1EE1110000001
1000C11111001
1P00000000001
1111111111111